XX...XXXXXXXXXXXXXXXXXXXXXXXXXXXXXXXXXXXXXXXXXXXXXXXXXXXXXXXXXXXXXXXXXXXXXXXXXXXXXXXXXXXXXXXXXXXXXXXXXXXXXXXXXXXXXXXXXXXXXXXXXXXXXXXXXXXXXXXXXXXXXXXXXXXXXXXXXXXX 
XX...XXXXXXXXXXXXXXXXXXXXXXXXXXXXXXXXXXXXXXXXXXXXXXXXXXXXXXXXXXXXXXXXXXXXXXXXXXXXXXXXXXXXXXXXXXXXXXXXXXXXXXXXXXXXXXXXXXXXXXXXXXXXXXXXXXXXXXXXXXXXXXXXXXXXXXXXXXXX 
XX....................XXXXXXXXXXXXXXXXXXXXXXXXXXXXXXXXXXXXXXXXXXXXXXXXXXXXXXXXXXXXXXXXXXXXXXXXXXXXXXXXXXXXXXXXXXXXXXXXXXXXXXXXXXXXXXXXXXXXXXXXXXXXXXXXXXXXXXXXXXX 
XX..............................XXXXXXXXXXXXXXXXXXXXXXXXXXXXXXXXXX..............XXXXXX..................................     ...................................W 
XX..........................................A.......A...B...A...................XXX...................................         .................................W 
XX........................xxxxx.............A.......A...B...A............Z..........................................             ...............................W 
XX.......X....XXXXXXXX......................A.......A...B...A..........XXXXXX........XX............................               ..............................W 
XX......XX...XXXXX...............XX.........A.......A...B...A..........XXXXXX...XXXXXXX............................               ..............................W 
XX....XXXXXXXXXXXX.......XXXXXXXXXX..XXXXXwwXwwwXwwwXwwwXwwwXwXXXXX....XXXXXXSSSXXXXXXX...............Z.........Z...             ...Z.........Z.........Z.......W 
XXXXXXXXXXXXXXXXXXXXXXXXXXXXXXXXXXXwwXXXXXXXXXXXXXXXXXXXXXXXXXXXXXXXSSXXXXXXXXXXXXXXXXXSSSwwwwwwwXXXXXXXXXXXXXXXXXXXXPPPPPPPPPPPXXXXXXXXXXXXXXXXXXXXXXXXXXXXXXXXX 
XXXXXXXXXXXXXXXXXXXXXXXXXXXXXXXXXXXXXXXXXXXXXXXXXXXXXXXXXXXXXXXXXXXXXXXXXXXXXXXXXXXXXXXXXXXXXXXXXXXXXXXXXXXXXXXXXXXXXX         XXXXXXXXXXXXXXXXXXXXXXXXXXXXXXXXXX 
XXXXXXXXXXXXXXXXXXXXXXXXXXXXXXXXXXXXXXXXXXXXXXXXXXXXXXXXXXXXXXXXXXXXXXXXXXXXXXXXXXXXXXXXXXXXXXXXXXXXXXXXXXXXXXXXXXXXXXwwwwwwwwwXXXXXXXXXXXXXXXXXXXXXXXXXXXXXXXXXX 
XXXXXXXXXXXXXXXXXXXXXXXXXXXXXXXXXXXXXXXXXXXXXXXXXXXXXXXXXXXXXXXXXXXXXXXXXXXXXXXXXXXXXXXXXXXXXXXXXXXXXXXXXXXXXXXXXXXXXXXXXXXXXXXXXXXXXXXXXXXXXXXXXXXXXXXXXXXXXXXXX
